XXXXXXXXXXXXXXXXXXXXXXXXXXX
XOXXXXGQQQQQQQQQQQQQGXXXXOX
XQQQQQtQXXXXXXXXXXXQtQQQQQX
XQQXXXXQQQQQQXQQQQQQXXXXQQX
XXQQQQTXXXXQQQQQXXXXTQQQQXX
XQQXXXQQQQQQXMXQQQQQQXXXQQX
XXQQQQTXXXXQQQQQXXXXTQQQQXX
XQQXXXtQQQQQQXQQQQQQtXXXXQX
XQQQQQQQXXXXQXQXXXXQQQQQQQX
XOXXXXGQQQQQQQQQQQQQGXXXXOX
XXXXXXXXXXXXXXXXXXXXXXXXXXX
