XXXXXXXXXXXXXXXXXXXXXXXXXXX
XOQQQQQQQQQQQQQQQQQQQQQQQOX
XQXXTXXXXXXtXXXtXXXXXXTXXQX
XQXXQQQQQQXQQQQQXQQQQQQXXQX
XGtQQQQQQQXXXTXXXQQQQQQQtGX
XXXXXXXTXXXQtMtQXXXTXXXXXXX
XGQQQQQQQQTQXQXQTQQQQQQQQGX
XtXXXXXTXQXQQQQQXQXTXXXXXtX
XQQQQQQQXQXXXXXXXQXQQQQQQQX
XOQXXQXQtQQQQQQQQQtQXQXXQOX
XXXXXXXXXXXXXXXXXXXXXXXXXXX